000000000000000000!
111000000000000000!
001000111111000000!
001000100001000000!
001111100001000000!
000000000001000000!
000000001111000000!
000000001000000000!
000000001111111111!
000000000000000000!
